10 9      // width height
0000000000
4343434343
3000000004
4212121213
3001002004
4002001003
3001002004
4002001003
3001002004
4002001003