9 6      //
444444444
333333333
222222222
333333333
222222222
444444444