9 6      //
044444440
333333333
111111111
022222220
001111100
000333000