11 13      //
00000000000
12121212121
43434343434
12121212121
43434343434
12121212121
43434343434
12121212121
43434343434
12121212121
43434343434
12121212121