9 6      //
040222040
333333333
111111111
222222222
333333333
040222040