9 7      //
044222440
011111110
333303333
111101111
222202222
011111110
044333440