10 12      //
4242424242
3131313131
0000022220
0000333300
0001111000
0044440000
0111100000
4343434343
1212121212