11 11      //
40000000004
43000000034
43200000234
43210001234
43211112344
43222222344
43211112344
43210001234
43200000234
43000000034
40000000004