11 12      //
40404040404
02020202020
30303030303
01010101010
40404040404
02020202020
30303030303
01010101010
40404040404
02020202020
30303030303
01010101010